1111111111111
1CC10000000C1
10C0011111001
1P0011E000001
1111111111111