11111111111111111111111111111
1E0000000C00000C0000000000001
10101000001010010000000101001
10100100100010010000000101111
100000C00000000000000000000P1
11101000001010010000000101001
10101000001010010000000101001
10101000001010010000000101001
10101000001010010000000101001
10101000001010010000000101001
10101000001010010000000101001
10101000001010010000000101001
10101000001010010000000101001
10101000001010010000000101001
11111111111111111111111111111